Question,1,2,3,4,5,N
Arbok,90,93,83,100,100,466
Aspen,84,82,83,82,100,431
Dratini,30,72,70,73,68,313
Finch,15,35,75,70,63,258
Genesee,62,82,55,58,57,314
Global,0,30,45,28,38,141
Goldeen,62,42,24,44,37,209
Nidoran,3,29,29,58,29,148
Paras,88,34,65,34,56,277
Sands,356,87,5,53,34,535
Spearow,4,14,24,34,4,80
Vulpix,33,55,5,43,100,236